AMBC::AMBC
AUBC::AUBC
Bravo::BRAV
Cartoon Network::CN
CBC::CBC
CBS::CBS
Comedy Central::CC
Cooking Channel::COOK
Crackle::CRKL
CraveTV::CRAV
CW::CWS?
DirecTV::DTV
Discovery Channel::DISC
Disney::DSNY
Facebook Watch::FBWatch
Freeform::FREE
FYI::FYI
go90::go90
Google Play::GP
HGTV::HGTV
History::HIST
Investigation Discovery::ID
iPlayer::iP
ITV Hub::iT
MNBC::MNBC
Motor Trend OnDemand::MTOD
MTV::MTV
NBC::NBC
Nickelodeon::NICK
PBS::PBS
Spike::SPIK
Stan::STAN
SyFy::SYFY
TLC::TLC
UKTV::UKTV
Viceland::VICE
VRV::VRV
WOWPlus::WOWPlus
Youtube Red::RED
